111111111111111
100100010000111
100000000000001
1P0000000011111
111100000000001
100000010000111
1000000100000E1
10C000010000011
100100100100001
111111111111111
