11111111111111111111111111111111111111
100E0000000000000001000000000000000001
10111111110111111101011111110111111101
10P00000000000000000000000000000000001
11011101110101111111011111110101111111
11000000000100011000000000110100000001
11011101110101001011N11010000101111101
1100000000010110101NNN1011110100000001
11011101101101101011111000000101101111
10000000000000000000000011110000000001
10111111110111111101011111110111111101
100000000000000C0001000000000000000001
11111111111111111111111111111111111111
