11111111111111111111111111111111111111
1N0E0000000000000001N000000000E0000001
1011111111011111110101111111N111111101
10P0000000000000000000000N000000000001
11011101110101111111011111110101111111
1100N000000100011N0000000N11010000E001
11011101110101001011011010000101111101
11000000000101101010C11011110100000001
11011101101101101011111000000101101111
1N00000000000000N000000N111100N0000001
10111111110111111101011111110111111101
1000000N0000000C00010000000000E0000001
11111111111111111111111111111111111111
